w w w o o o o
w g w w w w w
w g g o o o w
w o b b b h w
w o o o o w w
w w w w w w o